30
10
4
200
WWWWWWWWWWWWWWWWWWWWWWWWWWWWWW
WWWWWWWWWWWWWWWWWWWWWWWWWWWWWW
W                            W
W         C           R      W
WD                           W
WX         R          R      W
WMX       XXX      XXXXXXX   W
W         XXX                W
WXXXXXXXXXXXXXXXXXXXXXXXXXXXXW
WXXXXXXXXXXXXXXXXXXXXXXXXXXXXW
WWWWWWWWWWWWWWWWWWWWWWWWWWWWWW

