30
30
8
200
WWWWWWWWWWWWWWWWWWWWWWWWWWWWWW
WWWWWWWWWWWWWWWWWWWWWWWWWWWWWW
WX C XXXXXXXXXXR XXXXXXXXXXXXW
WXRXXXXXXXXXXXXXM  XXXXXXXXXXW
WWWWWWWWWWWWWWWWW WWWWWWWWWWWW
WDXXXXWXXXXXXXXXXXXXXXXXXXXXXW
WM    WXXXXXXXXXXXXXXXXXXXXXXW
W    MWXXXXXXXXXXXXXXXXXXXXWDW
WXXXXWWXXXXXXXXXXXXXXXXXXXXXXW
WXXXXXXXXXXXXXXRRRXXXXXXXXXXXW
WXXXXRRXXXXXXXXXXXXXXXXXXXXXXW
WXXXXXXXXXXRXXXXXXXXXXXXXXXRXW
WXXXXXXXXXXXXXXXXXXXXXXXXXXXXW
WXXXXXXXX  M    XXXXXXXX   M W
W  M     WWWWWW    D    WWWWWW
WWWWWWW  XXXXXX WWWWWWW XXXXXW
WXXXXXXXXXXXXXXXXXXXXXXXXXXRXW
WWWWWWXXXXXXXXXXXXXXXXXXXXXXXW
WWDDDWWWWWWWWWWWWWWWWWWW   M W
W RRRRRRRRRRRRRRRRRRRRRWXXXXXW
W XXXXXXXXXXXXXXXXXXXXXW  R  W
W                      WWWW  W
W        M             WXXWM W
W     M                WXXXXXW
W              M       WXXXXXW
W                       XXXXXW
WM           M          MWWWWW
WWWWWWWXXXXXXXXXXXXXXXWWWWWWWW
WED   MX  WWWWWXXXXXXXXXXXXXDW
WWWWWWWWWWWWWWWWWWWWWWWWWWWWWW
WWWWWWWWWWWWWWWWWWWWWWWWWWWWWW