10
10
2
200
WWWWWWWWWW
WXXXXXXXXW
WXXXCXXXXW
WXXXXXXXXW
WXXXXDDDDW
WX   MXXXW
WX    XXXW
WXRXXXXXXW
WXXXXXXXEW
WWWWWWWWWW