10
10
4
200
WWWWWWWWWW
WXXX XXXXW
WXXXCXXXXW
WXXXXXXXXW
WXXXXDDDDW
WX   MXXXW
WX    MXXXW
WXRXXXXXXW
WXXXXXXXEW
WWWWWWWWWW