30
30
2
200
WWWWWWWWWWWWWWWWWWWWWWWWWWWWWW
WXXCXXXXXXXXXXXXXXXXXXXXXXXXXW
WXXXXXXXXXXXXXXXXXXXXXXXXXXXXW
WXXXXXXXXXXXXXXXXXXXXXXXXXXXXW
WXXXXDDDDXXXXXXXXXXXXXXXXXXXXW
WX   MXXXXXXXXXXXXXXXXXXXXXXXW
WXXXXXXX            XXXXXXXXXW
WXXXXXXX            XXXXXXXXXW
WXXXXXXX            XXXXXXXXXW
WXXXXXXX            XXXXXXXXXW
WXXXXXXX            XXXXXXXXXW
WXXXXXXX            XXXXXXXXXW
WXXXXXXX            XXXXXXXXXW
WXXXXXXX            XXXXXXXXXW
WXXXXXXXXXXXXX   M XXXXXXXXXXW
WXXXXXXX            XXXXXXXXXW
WXXXXXXX            XXXXXXXXXW
WXXXXXXX           EXXXXXXXXXW
WXXXXXXXXXXXXXXXXXXXXXXXXXXXXW
WXXXXXXXXXXXXXXXXXXXXXXXXXXXXW
WXXXXXXXXXXXXXXXXXXXXXXXXXXXXW
WXXXXXXXXXXXXXXXXXXXXXXXXXXXXW
WXXXXXXXXXXXXXXXXXXXXXXXXXXXXW
WXXXXXXXXXXXXXXXXXXXXXXXXXXXXW
WXXXXXXXXXXXXXXXXXXXXXXXXXXXXW
WXXXXXXXXXXXXXXXX XXXXXXXXXXXW
WXXXXXXXXXXXXXXXXXXXXXXXXXXXXW
WXXXXXXXXXXXXXXXXXXXXXXXXXXXXW
WXXXXXXXXXXXXXXXXXXXXXXXXXXXEW
WWWWWWWWWWWWWWWWWWWWWWWWWWWWWW
